11111111111111111111111111111111111111111111111111111111111
1P000000000000000000000000000000000000000000000000000000001
11111111110000000000000000000000000000000000000000000000001
100000000111111110000000CCCCC000000000000000000000000000001
10000000000000001000000000000000000000000000000000000000001
10000000000000001000000000000000000000000000000000000000001
10000000000000001111100000000000000000000000000000000000001
10000000000000001000000000000000000000000000000000000000001
10000000000000000000000000000000000000000000000000000000001
10000000000000000000000000000000000000000000000000000000001
10000000000000000000000000000000000000000000000000000000001
10000000000000000000000000000000000000000000000000000000001
10000000000000000000000000000000000000000000000000000000001
10000000000000000000000000000000000000000000000000000000001
11111111111111111111111111111111111111111111111111111111111
