111111111111111111
1PE000000C0000C001
1111100C000000C001
10C0000000C0000001
10000000001100C001
10C00C000C0000C001
111111111111111111
