11111111111111111111111111
1P0C000000000C000000000001
111111111111000000000C0001
1E00000000000C0000000C0001
11111111111111111111111111
