11111111111111
10000000000001
100000P0000001
1000P000000001
10000000000001
10E00000000001
11111111111111
